NO ./textures/greystone.png
SO ./textures/mossy.png
WE ./textures/eagle.png
EA ./textures/redbrick.png

F 8000,255,255
C -10,0,0

11111
1N001
10001
11111
